Date,Team,Where,Opp,Result,MP,FGA,3P,3PA,FT,FTA,ORB,DRB,TRB,AST,PTS,PAR,PA,PR,AR,name
2024-10-23,DET,,IND,"L, 109-115",15:18,6,0,3,2,2,1,2,3,0,6,9,6,9,3,ron
2024-10-25,DET,@,CLE,"L, 101-113",17:11,6,0,2,0,0,0,7,7,1,4,12,5,11,8,ron
2024-10-26,DET,,BOS,"L, 118-124",06:13,4,1,3,0,0,0,1,1,1,5,7,6,6,2,ron
2024-10-28,DET,@,MIA,"L, 98-106",14:12,6,0,1,0,0,0,2,2,0,6,8,6,8,2,ron
2024-10-30,DET,@,PHI,"W, 105-95",12:55,4,0,0,0,0,0,3,3,0,6,9,6,9,3,ron
2024-11-01,DET,,NYK,"L, 98-128",22:27,6,0,2,1,1,0,2,2,1,9,12,10,11,3,ron
2024-11-03,DET,@,BRK,"W, 106-92",10:20,1,0,0,0,0,0,0,0,1,0,1,1,0,1,ron
2024-11-04,DET,,LAL,"W, 115-103",16:39,9,0,5,4,4,1,3,4,0,12,16,12,16,4,ron
2024-11-06,DET,@,CHO,"L, 107-108",15:32,5,2,3,0,0,1,3,4,0,8,12,8,12,4,ron
2024-11-08,DET,,ATL,"W, 122-121",13:37,5,0,1,1,1,1,0,1,0,5,6,5,6,1,ron
2024-11-10,DET,,HOU,"L, 99-101",13:18,6,1,6,1,2,0,1,1,0,4,5,4,5,1,ron
2024-11-12,DET,,MIA,"W, 123-121 (OT)",16:03,2,0,0,2,2,2,2,4,1,2,7,3,6,5,ron
2024-11-13,DET,@,MIL,"L, 120-127 (OT)",28:35,10,0,2,1,3,0,4,4,2,11,17,13,15,6,ron
2024-11-15,DET,@,TOR,"W, 99-95",21:23,11,0,6,4,4,4,4,8,0,10,18,10,18,8,ron
2024-11-17,DET,@,WAS,"W, 124-104",14:53,3,0,1,0,0,0,2,2,0,0,2,0,2,2,ron
2024-11-18,DET,,CHI,"L, 112-122",09:02,2,0,0,0,0,1,3,4,1,2,7,3,6,5,ron
2024-11-21,DET,@,CHO,"L, 121-123 (OT)",13:46,5,1,3,1,1,0,2,2,1,6,9,7,8,3,ron
2024-11-23,DET,@,ORL,"L, 100-111",15:58,6,0,2,2,2,0,4,4,0,4,8,4,8,4,ron
2024-11-25,DET,,TOR,"W, 102-100",11:25,5,0,2,0,0,0,1,1,0,4,5,4,5,1,ron
2024-11-27,DET,@,MEM,"L, 111-131",25:53,8,2,2,2,4,0,3,3,0,14,17,14,17,3,ron
2024-11-29,DET,@,IND,"W, 130-106",12:06,4,0,0,0,0,2,5,7,2,6,15,8,13,9,ron
2024-11-30,DET,,PHI,"L, 96-111",22:41,3,0,2,0,0,1,2,3,1,2,6,3,5,4,ron
2024-12-03,DET,,MIL,"L, 107-128",12:22,4,0,1,0,0,0,1,1,2,2,5,4,3,3,ron
2024-12-04,DET,@,BOS,"L, 120-130",16:17,4,2,3,1,2,0,2,2,3,7,12,10,9,5,ron
2024-12-07,DET,@,NYK,"W, 120-111",18:28,2,0,0,0,0,0,3,3,2,4,9,6,7,5,ron
2024-12-12,DET,@,BOS,"L, 99-123",20:58,14,2,5,2,2,1,2,3,0,26,29,26,29,3,ron
2024-12-16,DET,,MIA,"W, 125-124 (OT)",23:13,5,1,1,1,2,0,4,4,0,8,12,8,12,4,ron
2024-12-19,DET,,UTA,"L, 119-126",12:32,2,0,1,2,2,1,2,3,0,4,7,4,7,3,ron
2024-12-21,DET,@,PHO,"W, 133-125",13:33,4,0,1,0,0,0,3,3,1,4,8,5,7,4,ron
2024-12-23,DET,@,LAL,"W, 117-114",12:44,7,0,1,0,0,1,3,4,1,10,15,11,14,5,ron
2024-12-26,DET,@,SAC,"W, 114-113",06:39,2,0,0,0,0,0,1,1,0,0,1,0,1,1,ron
2024-12-28,DET,@,DEN,"L, 121-134",19:46,9,1,1,1,2,0,2,2,0,12,14,12,14,2,ron
2025-01-01,DET,,ORL,"W, 105-96",10:09,2,0,0,0,0,0,0,0,1,2,3,3,2,1,ron
2025-01-03,DET,,CHO,"W, 98-94",10:50,8,1,3,0,0,0,3,3,1,9,13,10,12,4,ron
2025-01-04,DET,,MIN,"W, 119-105",16:56,3,0,0,4,4,1,1,2,1,8,11,9,10,3,ron
2025-01-06,DET,,POR,"W, 118-115",14:46,4,0,1,2,2,1,1,2,1,8,11,9,10,3,ron
2025-01-08,DET,@,BRK,"W, 113-98",27:54,7,0,2,0,1,0,5,5,3,8,16,11,13,8,ron
2025-01-09,DET,,GSW,"L, 104-107",19:47,9,3,8,2,2,0,1,1,1,11,13,12,12,2,ron
2025-01-11,DET,,TOR,"W, 123-114",14:55,5,1,4,0,0,2,2,4,1,3,8,4,7,5,ron
2025-01-13,DET,@,NYK,"W, 124-119",14:30,4,0,1,0,0,0,2,2,1,6,9,7,8,3,ron
2025-01-16,DET,,IND,"L, 100-111",07:46,4,0,2,2,2,0,0,0,0,4,4,4,4,0,ron
2025-01-18,DET,,PHO,"L, 121-125",15:30,6,2,4,1,2,0,2,2,1,9,12,10,11,3,ron
2025-01-20,DET,@,HOU,"W, 107-96",15:38,3,1,2,0,0,0,1,1,2,3,6,5,4,3,ron
2025-01-22,DET,@,ATL,"W, 114-104",11:43,3,0,0,2,2,0,5,5,0,2,7,2,7,5,ron
2025-01-25,DET,@,ORL,"L, 113-121",15:47,7,2,3,5,8,1,3,4,1,13,18,14,17,5,ron
2025-01-27,DET,@,CLE,"L, 91-110",15:53,6,0,2,0,0,2,2,4,1,4,9,5,8,5,ron
2025-01-29,DET,@,IND,"L, 119-133",09:25,7,2,4,0,0,1,1,2,1,6,9,7,8,3,ron
2025-01-31,DET,,DAL,"W, 117-102",13:36,8,0,1,0,0,1,2,3,0,4,7,4,7,3,ron
2025-02-02,DET,,CHI,"W, 127-119",14:52,5,0,0,2,2,0,0,0,2,8,10,10,8,2,ron
2025-02-03,DET,,ATL,"L, 130-132",15:40,3,1,2,1,1,0,3,3,1,6,10,7,9,4,ron
2025-02-05,DET,,CLE,"L, 115-118",19:11,7,1,5,2,2,1,0,1,1,9,11,10,10,2,ron
2025-02-07,DET,,PHI,"W, 125-112",14:33,5,1,3,0,0,0,1,1,2,3,6,5,4,3,ron
2025-02-09,DET,,CHO,"W, 112-102",13:32,9,1,6,0,0,0,2,2,2,9,13,11,11,4,ron
2025-02-11,DET,@,CHI,"W, 132-92",22:36,4,0,2,2,2,0,3,3,1,2,6,3,5,4,ron
2025-02-12,DET,@,CHI,"W, 128-110",13:12,3,0,1,0,0,0,1,1,1,0,2,1,1,2,ron
2025-02-21,DET,@,SAS,"W, 125-110",19:35,4,0,3,2,3,0,5,5,0,4,9,4,9,5,ron
2025-02-23,DET,@,ATL,"W, 148-143",13:21,2,0,1,2,2,0,1,1,1,4,6,5,5,2,ron
2025-02-24,DET,,LAC,"W, 106-97",12:41,3,0,0,3,5,1,1,2,0,7,9,7,9,2,ron
2025-02-26,DET,,BOS,"W, 117-97",18:58,8,0,3,0,0,1,2,3,3,8,14,11,11,6,ron
2025-02-28,DET,,DEN,"L, 119-134",20:27,5,0,1,2,2,1,3,4,1,8,13,9,12,5,ron
2025-03-01,DET,,BRK,"W, 115-94",15:38,4,0,0,2,2,0,2,2,2,10,14,12,12,4,ron
2025-03-03,DET,@,UTA,"W, 134-106",18:15,2,0,0,4,6,0,1,1,2,8,11,10,9,3,ron
2025-03-05,DET,@,LAC,"L, 115-123",12:22,3,0,1,3,4,0,0,0,0,7,7,7,7,0,ron
2025-03-08,DET,@,GSW,"L, 110-115",10:33,5,0,2,0,0,1,0,1,0,4,5,4,5,1,ron
2025-03-09,DET,@,POR,"W, 119-112",10:05,3,0,0,1,1,0,1,1,1,3,5,4,4,2,ron
2025-03-11,DET,,WAS,"W, 123-103",17:56,7,0,2,0,0,0,4,4,2,4,10,6,8,6,ron
2025-03-13,DET,,WAS,"L, 125-129",11:13,4,0,2,1,1,1,3,4,0,3,7,3,7,4,ron
2025-03-15,DET,,OKC,"L, 107-113",09:33,4,0,1,0,0,0,3,3,2,6,11,8,9,5,ron
2025-03-17,DET,@,NOP,"W, 127-81",19:54,4,0,1,4,6,1,1,2,3,10,15,13,12,5,ron
2025-03-19,DET,@,MIA,"W, 116-113",12:23,4,0,1,1,1,0,1,1,1,7,9,8,8,2,ron
2025-03-21,DET,@,DAL,"L, 117-123",12:25,9,1,4,1,1,1,4,5,1,12,18,13,17,6,ron
2025-03-23,DET,,NOP,"W, 136-130",35:44,14,1,3,5,11,1,4,5,6,26,37,32,31,11,ron
2025-03-25,DET,,SAS,"W, 122-96",17:47,4,1,1,1,1,1,5,6,2,8,16,10,14,8,ron
2025-03-28,DET,,CLE,"W, 133-122",19:00,5,2,3,0,0,0,2,2,1,10,13,11,12,3,ron
2025-03-30,DET,@,MIN,"L, 104-123",07:22,4,0,0,2,2,0,2,2,1,4,7,5,6,3,ron
2025-04-04,DET,@,TOR,"W, 117-105",13:22,2,0,1,3,4,2,3,5,3,3,11,6,8,8,ron
2025-04-05,DET,,MEM,"L, 103-109",10:03,1,0,0,1,2,0,0,0,0,3,3,3,3,0,ron
2025-04-07,DET,,SAC,"L, 117-127",15:22,3,0,0,1,1,1,3,4,1,5,10,6,9,5,ron
2025-04-10,DET,,NYK,"W, 115-106",21:33,11,1,2,0,0,1,4,5,0,13,18,13,18,5,ron
2025-04-11,DET,,MIL,"L, 119-125",13:28,5,0,1,0,0,0,3,3,1,0,4,1,3,4,ron
2025-04-13,DET,@,MIL,"L, 133-140 (OT)",22:36,4,1,2,0,1,0,0,0,1,5,6,6,5,1,ron
