Date,Team,Where,Opp,Result,MP,FGA,3P,3PA,FT,FTA,ORB,DRB,TRB,AST,PTS,PAR,PA,PR,AR,name
2024-10-23,DET,,IND,"L, 109-115",35:47,13,1,6,0,0,1,1,2,1,13,16,14,15,3,tobias
2024-10-25,DET,@,CLE,"L, 101-113",34:40,9,2,3,2,2,0,5,5,4,10,19,14,15,9,tobias
2024-10-26,DET,,BOS,"L, 118-124",31:29,11,0,5,4,4,2,9,11,3,8,22,11,19,14,tobias
2024-10-28,DET,@,MIA,"L, 98-106",36:44,11,0,3,1,1,2,8,10,1,9,20,10,19,11,tobias
2024-10-30,DET,@,PHI,"W, 105-95",35:05,18,0,3,2,2,0,14,14,1,18,33,19,32,15,tobias
2024-11-01,DET,,NYK,"L, 98-128",25:33,8,1,2,2,2,0,8,8,3,13,24,16,21,11,tobias
2024-11-03,DET,@,BRK,"W, 106-92",34:38,13,1,4,1,1,3,2,5,6,18,29,24,23,11,tobias
2024-11-04,DET,,LAL,"W, 115-103",30:03,15,1,7,0,0,0,7,7,1,15,23,16,22,8,tobias
2024-11-06,DET,@,CHO,"L, 107-108",31:57,12,0,3,0,1,0,7,7,3,14,24,17,21,10,tobias
2024-11-08,DET,,ATL,"W, 122-121",30:34,13,5,8,3,4,0,6,6,2,22,30,24,28,8,tobias
2024-11-10,DET,,HOU,"L, 99-101",34:42,5,1,2,2,5,2,6,8,1,9,18,10,17,9,tobias
2024-11-12,DET,,MIA,"W, 123-121 (OT)",40:07,15,2,4,2,2,2,5,7,4,18,29,22,25,11,tobias
2024-11-13,DET,@,MIL,"L, 120-127 (OT)",44:12,15,2,5,0,0,0,8,8,5,10,23,15,18,13,tobias
2024-11-15,DET,@,TOR,"W, 99-95",27:48,13,1,4,0,0,2,9,11,3,11,25,14,22,14,tobias
2024-11-17,DET,@,WAS,"W, 124-104",28:23,11,1,3,3,4,2,7,9,3,12,24,15,21,12,tobias
2024-11-18,DET,,CHI,"L, 112-122",32:00,15,1,4,1,1,0,2,2,0,16,18,16,18,2,tobias
2024-11-21,DET,@,CHO,"L, 121-123 (OT)",30:52,16,6,9,0,0,3,5,8,2,26,36,28,34,10,tobias
2024-11-23,DET,@,ORL,"L, 100-111",28:59,9,0,3,2,3,1,4,5,1,8,14,9,13,6,tobias
2024-11-25,DET,,TOR,"W, 102-100",37:29,10,1,4,5,6,0,3,3,2,12,17,14,15,5,tobias
2024-11-29,DET,@,IND,"W, 130-106",29:47,8,2,5,4,4,0,5,5,3,16,24,19,21,8,tobias
2024-11-30,DET,,PHI,"L, 96-111",22:37,8,0,3,2,3,1,6,7,2,4,13,6,11,9,tobias
2024-12-03,DET,,MIL,"L, 107-128",32:48,10,2,5,4,4,2,3,5,3,16,24,19,21,8,tobias
2024-12-04,DET,@,BOS,"L, 120-130",31:14,17,6,9,3,3,1,2,3,2,27,32,29,30,5,tobias
2024-12-07,DET,@,NYK,"W, 120-111",33:32,8,1,4,4,4,1,8,9,1,13,23,14,22,10,tobias
2024-12-12,DET,@,BOS,"L, 99-123",25:38,9,1,3,0,0,1,7,8,3,9,20,12,17,11,tobias
2024-12-19,DET,,UTA,"L, 119-126",30:17,13,0,3,2,2,2,5,7,2,8,17,10,15,9,tobias
2024-12-21,DET,@,PHO,"W, 133-125",29:10,5,1,2,3,4,0,3,3,2,10,15,12,13,5,tobias
2024-12-23,DET,@,LAL,"W, 117-114",29:14,10,0,3,0,0,0,1,1,4,6,11,10,7,5,tobias
2024-12-26,DET,@,SAC,"W, 114-113",27:03,7,0,2,2,2,0,3,3,2,4,9,6,7,5,tobias
2024-12-28,DET,@,DEN,"L, 121-134",23:30,6,1,4,2,2,1,1,2,1,7,10,8,9,3,tobias
2025-01-01,DET,,ORL,"W, 105-96",34:52,9,2,4,1,2,2,6,8,2,17,27,19,25,10,tobias
2025-01-03,DET,,CHO,"W, 98-94",36:04,16,4,5,2,2,3,7,10,1,24,35,25,34,11,tobias
2025-01-04,DET,,MIN,"W, 119-105",33:39,13,2,5,4,4,2,9,11,4,16,31,20,27,15,tobias
2025-01-06,DET,,POR,"W, 118-115",37:07,8,2,3,5,5,1,4,5,3,17,25,20,22,8,tobias
2025-01-08,DET,@,BRK,"W, 113-98",25:52,9,1,3,0,0,0,3,3,5,9,17,14,12,8,tobias
2025-01-09,DET,,GSW,"L, 104-107",32:25,8,1,3,0,0,0,4,4,4,13,21,17,17,8,tobias
2025-01-11,DET,,TOR,"W, 123-114",34:50,12,2,5,3,3,0,7,7,3,17,27,20,24,10,tobias
2025-01-13,DET,@,NYK,"W, 124-119",36:06,12,1,3,4,4,2,6,8,3,11,22,14,19,11,tobias
2025-01-16,DET,,IND,"L, 100-111",36:19,11,0,2,0,0,0,4,4,2,10,16,12,14,6,tobias
2025-01-18,DET,,PHO,"L, 121-125",36:30,15,2,5,1,1,1,4,5,2,21,28,23,26,7,tobias
2025-01-20,DET,@,HOU,"W, 107-96",33:54,9,0,1,0,0,0,4,4,3,4,11,7,8,7,tobias
2025-01-22,DET,@,ATL,"W, 114-104",37:10,7,2,3,1,2,1,1,2,1,9,12,10,11,3,tobias
2025-01-25,DET,@,ORL,"L, 113-121",17:09,3,0,0,0,0,1,6,7,2,2,11,4,9,9,tobias
2025-01-27,DET,@,CLE,"L, 91-110",27:21,9,0,4,0,0,0,2,2,1,2,5,3,4,3,tobias
2025-01-29,DET,@,IND,"L, 119-133",35:49,19,1,8,2,2,0,8,8,2,19,29,21,27,10,tobias
2025-01-31,DET,,DAL,"W, 117-102",30:43,12,1,3,2,2,1,2,3,1,17,21,18,20,4,tobias
2025-02-02,DET,,CHI,"W, 127-119",34:00,15,0,3,0,1,0,6,6,2,16,24,18,22,8,tobias
2025-02-03,DET,,ATL,"L, 130-132",35:14,13,0,3,6,7,0,4,4,2,22,28,24,26,6,tobias
2025-02-05,DET,,CLE,"L, 115-118",25:21,9,0,2,2,2,0,2,2,1,8,11,9,10,3,tobias
2025-02-07,DET,,PHI,"W, 125-112",33:47,16,0,0,6,6,4,5,9,3,22,34,25,31,12,tobias
2025-02-09,DET,,CHO,"W, 112-102",33:43,13,1,2,1,1,0,4,4,1,20,25,21,24,5,tobias
2025-02-11,DET,@,CHI,"W, 132-92",25:04,13,2,6,0,0,0,3,3,0,18,21,18,21,3,tobias
2025-02-12,DET,@,CHI,"W, 128-110",32:47,11,1,2,6,7,2,3,5,0,19,24,19,24,5,tobias
2025-02-21,DET,@,SAS,"W, 125-110",30:27,10,2,3,4,4,1,6,7,2,22,31,24,29,9,tobias
2025-02-23,DET,@,ATL,"W, 148-143",34:51,12,0,3,2,2,1,3,4,3,12,19,15,16,7,tobias
2025-02-24,DET,,LAC,"W, 106-97",38:08,13,2,3,0,1,0,5,5,2,20,27,22,25,7,tobias
2025-02-26,DET,,BOS,"W, 117-97",34:01,10,2,4,2,2,2,7,9,2,16,27,18,25,11,tobias
2025-02-28,DET,,DEN,"L, 119-134",25:37,10,2,4,0,0,1,1,2,3,12,17,15,14,5,tobias
2025-03-01,DET,,BRK,"W, 115-94",32:22,12,1,2,5,5,0,9,9,2,18,29,20,27,11,tobias
2025-03-08,DET,@,GSW,"L, 110-115",36:00,11,0,2,7,8,1,11,12,2,15,29,17,27,14,tobias
2025-03-09,DET,@,POR,"W, 119-112",36:56,13,1,3,1,2,2,7,9,2,20,31,22,29,11,tobias
2025-03-11,DET,,WAS,"W, 123-103",30:42,12,2,4,0,0,1,7,8,1,12,21,13,20,9,tobias
2025-03-13,DET,,WAS,"L, 125-129",36:08,12,2,4,2,3,2,4,6,3,14,23,17,20,9,tobias
2025-03-15,DET,,OKC,"L, 107-113",34:24,12,2,3,4,4,0,7,7,0,18,25,18,25,7,tobias
2025-03-17,DET,@,NOP,"W, 127-81",25:18,8,0,4,3,4,1,5,6,0,9,15,9,15,6,tobias
2025-03-19,DET,@,MIA,"W, 116-113",35:14,9,0,1,1,2,0,5,5,2,13,20,15,18,7,tobias
2025-03-21,DET,@,DAL,"L, 117-123",34:45,11,1,4,0,0,2,4,6,3,9,18,12,15,9,tobias
2025-03-23,DET,,NOP,"W, 136-130",32:04,15,0,4,0,0,1,2,3,4,14,21,18,17,7,tobias
2025-03-25,DET,,SAS,"W, 122-96",27:16,10,3,5,4,4,0,8,8,4,15,27,19,23,12,tobias
2025-04-02,DET,@,OKC,"L, 103-119",21:52,8,0,1,0,0,0,4,4,2,10,16,12,14,6,tobias
2025-04-10,DET,,NYK,"W, 115-106",27:55,9,3,5,4,4,1,1,2,2,17,21,19,19,4,tobias
2025-04-11,DET,,MIL,"L, 119-125",29:48,10,3,4,2,4,0,4,4,3,17,24,20,21,7,tobias
2025-04-13,DET,@,MIL,"L, 133-140 (OT)",10:03,3,0,1,0,0,0,3,3,1,4,8,5,7,4,tobias
