Date,Team,Where,Opp,Result,MP,FGA,3P,3PA,FT,FTA,ORB,DRB,TRB,AST,PTS,PAR,PA,PR,AR,name
2024-10-23,IND,@,DET,"W, 115-109",16:02,2,0,1,0,0,0,1,1,2,2,5,4,3,3,obi
2024-10-25,IND,@,NYK,"L, 98-123",19:48,6,0,1,0,0,0,1,1,4,8,13,12,9,5,obi
2024-10-27,IND,,PHI,"L, 114-118 (OT)",22:51,8,1,3,6,7,2,2,4,1,15,20,16,19,5,obi
2024-10-28,IND,@,ORL,"L, 115-119",14:12,6,3,4,1,2,1,1,2,0,14,16,14,16,2,obi
2024-10-30,IND,,BOS,"W, 135-132 (OT)",33:25,15,2,7,4,4,3,4,7,3,18,28,21,25,10,obi
2024-11-01,IND,@,NOP,"L, 118-125",18:47,6,1,3,0,0,1,4,5,0,7,12,7,12,5,obi
2024-11-04,IND,@,DAL,"W, 134-127",24:16,8,1,3,0,0,1,5,6,2,11,19,13,17,8,obi
2024-11-06,IND,,ORL,"W, 118-111",16:56,3,0,0,0,0,0,0,0,1,4,5,5,4,1,obi
2024-11-08,IND,@,CHO,"L, 83-103",20:37,4,0,2,0,0,1,1,2,1,2,5,3,4,3,obi
2024-11-13,IND,@,ORL,"L, 90-94",18:38,4,0,3,0,0,1,2,3,2,2,7,4,5,5,obi
2024-11-15,IND,,MIA,"L, 111-124",21:28,10,3,5,2,2,0,3,3,0,21,24,21,24,3,obi
2024-11-17,IND,,MIA,"W, 119-110",17:49,8,0,2,0,0,1,2,3,2,8,13,10,11,5,obi
2024-11-18,IND,@,TOR,"L, 119-130",31:00,13,3,8,0,0,0,2,2,5,19,26,24,21,7,obi
2024-11-20,IND,@,HOU,"L, 113-130",13:08,6,0,4,0,0,0,3,3,0,4,7,4,7,3,obi
2024-11-22,IND,@,MIL,"L, 117-129",16:40,9,0,3,0,0,2,2,4,3,6,13,9,10,7,obi
2024-11-24,IND,,WAS,"W, 115-103",15:52,6,1,1,0,0,1,2,3,0,11,14,11,14,3,obi
2024-11-25,IND,,NOP,"W, 114-110",15:50,8,1,4,0,0,0,2,2,2,7,11,9,9,4,obi
2024-11-27,IND,,POR,"W, 121-114",15:39,3,2,2,0,0,0,5,5,2,6,13,8,11,7,obi
2024-11-29,IND,,DET,"L, 106-130",25:17,5,0,2,3,3,0,3,3,2,5,10,7,8,5,obi
2024-12-01,IND,@,MEM,"L, 121-136",22:04,10,1,4,1,2,0,8,8,1,16,25,17,24,9,obi
2024-12-03,IND,@,TOR,"L, 111-122",14:25,10,2,4,1,1,2,7,9,1,15,25,16,24,10,obi
2024-12-04,IND,@,BRK,"L, 90-99",24:06,11,1,6,2,2,1,4,5,2,13,20,15,18,7,obi
2024-12-06,IND,@,CHI,"W, 132-123",21:19,8,3,4,2,2,0,7,7,5,17,29,22,24,12,obi
2024-12-08,IND,,CHO,"L, 109-113",22:44,11,3,9,0,0,0,3,3,2,11,16,13,14,5,obi
2024-12-13,IND,@,PHI,"W, 121-107",30:55,11,2,4,4,4,2,6,8,3,20,31,23,28,11,obi
2024-12-15,IND,,NOP,"W, 119-104",20:35,8,4,6,0,0,0,5,5,2,16,23,18,21,7,obi
2024-12-19,IND,@,PHO,"W, 120-111",17:03,7,2,5,3,4,1,7,8,1,13,22,14,21,9,obi
2024-12-22,IND,@,SAC,"W, 122-95",21:21,8,1,4,2,3,1,2,3,2,11,16,13,14,5,obi
2024-12-23,IND,@,GSW,"W, 111-105",18:28,6,0,1,0,0,0,4,4,1,8,13,9,12,5,obi
2024-12-26,IND,,OKC,"L, 114-120",06:49,2,1,1,0,0,0,3,3,0,5,8,5,8,3,obi
2024-12-31,IND,,MIL,"L, 112-120",12:25,3,0,1,2,4,0,2,2,2,4,8,6,6,4,obi
2025-01-02,IND,@,MIA,"W, 128-115",20:19,9,2,4,0,0,1,5,6,0,12,18,12,18,6,obi
2025-01-04,IND,,PHO,"W, 126-108",16:23,6,0,2,6,6,3,0,3,2,12,17,14,15,5,obi
2025-01-06,IND,@,BRK,"W, 113-99",21:33,6,1,2,2,2,1,4,5,0,11,16,11,16,5,obi
2025-01-08,IND,,CHI,"W, 129-113",23:04,9,1,4,1,2,1,4,5,2,12,19,14,17,7,obi
2025-01-10,IND,,GSW,"W, 108-96",16:14,3,0,2,0,0,0,4,4,1,2,7,3,6,5,obi
2025-01-12,IND,@,CLE,"W, 108-93",17:32,10,1,4,1,2,0,2,2,1,12,15,13,14,3,obi
2025-01-14,IND,,CLE,"L, 117-127",19:39,9,2,3,0,0,0,3,3,3,10,16,13,13,6,obi
2025-01-16,IND,@,DET,"W, 111-100",16:52,5,1,3,2,4,1,4,5,0,7,12,7,12,5,obi
2025-01-18,IND,,PHI,"W, 115-102",12:13,5,0,2,0,0,0,2,2,2,4,8,6,6,4,obi
2025-01-23,IND,,SAS,"L, 110-140",19:00,7,3,5,2,2,0,3,3,2,13,18,15,16,5,obi
2025-01-25,IND,@,SAS,"W, 136-98",13:29,8,1,4,0,0,1,4,5,2,7,14,9,12,7,obi
2025-01-29,IND,,DET,"W, 133-119",16:32,0,0,0,1,2,0,1,1,0,1,2,1,2,1,obi
2025-02-01,IND,,ATL,"W, 132-127",15:22,11,1,3,1,2,2,7,9,0,18,27,18,27,9,obi
2025-02-03,IND,@,UTA,"W, 112-111",19:08,10,3,8,0,0,0,3,3,0,13,16,13,16,3,obi
2025-02-04,IND,@,POR,"L, 89-112",08:39,2,0,2,0,0,0,2,2,0,0,2,0,2,2,obi
2025-02-06,IND,@,LAC,"W, 119-112",27:41,9,0,3,2,2,2,4,6,2,10,18,12,16,8,obi
2025-02-08,IND,@,LAL,"L, 117-124",22:29,8,3,5,3,4,1,4,5,3,14,22,17,19,8,obi
2025-02-11,IND,,NYK,"L, 115-128",20:36,8,0,3,1,2,0,3,3,1,9,13,10,12,4,obi
2025-02-12,IND,@,WAS,"W, 134-130 (OT)",32:38,19,6,11,3,3,3,7,10,2,31,43,33,41,12,obi
2025-02-20,IND,,MEM,"W, 127-113",19:54,6,2,4,2,3,0,5,5,1,12,18,13,17,6,obi
2025-02-23,IND,,LAC,"W, 129-111",23:39,9,0,4,0,0,2,3,5,6,10,21,16,15,11,obi
2025-02-24,IND,,DEN,"L, 116-125",17:05,8,1,5,2,2,0,3,3,2,11,16,13,14,5,obi
2025-02-26,IND,,TOR,"W, 111-91",13:44,8,0,5,0,0,0,1,1,0,4,5,4,5,1,obi
2025-02-28,IND,@,MIA,"L, 120-125",15:33,4,1,2,0,0,0,1,1,0,7,8,7,8,1,obi
2025-03-02,IND,,CHI,"W, 127-112",16:12,5,0,1,0,0,0,5,5,1,6,12,7,11,6,obi
2025-03-04,IND,,HOU,"W, 115-102",16:26,6,3,4,2,2,1,4,5,1,13,19,14,18,6,obi
2025-03-06,IND,@,ATL,"L, 118-124",19:16,5,1,3,0,0,0,2,2,3,3,8,6,5,5,obi
2025-03-08,IND,@,ATL,"L, 118-120",17:59,6,0,2,3,4,1,2,3,1,9,13,10,12,4,obi
2025-03-10,IND,@,CHI,"L, 103-121",20:19,8,0,2,2,2,1,2,3,1,10,14,11,13,4,obi
2025-03-11,IND,,MIL,"W, 115-114",05:32,2,0,1,1,1,0,0,0,0,3,3,3,3,0,obi
2025-03-14,IND,@,PHI,"W, 112-100",25:14,7,0,2,3,4,2,6,8,3,11,22,14,19,11,obi
2025-03-15,IND,@,MIL,"L, 119-126",22:34,9,2,6,0,1,0,3,3,3,8,14,11,11,6,obi
2025-03-17,IND,@,MIN,"W, 132-130 (OT)",44:56,19,7,10,3,4,2,8,10,2,34,46,36,44,12,obi
2025-03-19,IND,,DAL,"W, 135-131",22:35,6,3,4,2,2,1,3,4,2,13,19,15,17,6,obi
2025-03-20,IND,,BRK,"W, 105-99 (OT)",17:35,6,0,2,3,3,1,2,3,1,7,11,8,10,4,obi
2025-03-22,IND,,BRK,"W, 108-103",17:44,9,1,4,1,1,1,4,5,0,10,15,10,15,5,obi
2025-03-24,IND,,MIN,"W, 119-103",23:35,10,6,9,0,0,0,1,1,1,20,22,21,21,2,obi
2025-03-26,IND,,LAL,"L, 119-120",18:58,7,2,5,0,1,1,1,2,0,10,12,10,12,2,obi
2025-03-27,IND,@,WAS,"W, 162-109",16:29,9,1,3,0,0,0,2,2,4,15,21,19,17,6,obi
2025-03-29,IND,@,OKC,"L, 111-132",22:09,9,2,6,0,0,1,2,3,5,12,20,17,15,8,obi
2025-03-31,IND,,SAC,"W, 111-109",21:42,11,5,8,0,0,1,6,7,0,19,26,19,26,7,obi
2025-04-02,IND,,CHO,"W, 119-105",18:14,8,1,5,1,1,0,4,4,1,8,13,9,12,5,obi
2025-04-04,IND,,UTA,"W, 140-112",19:05,4,1,3,1,2,0,4,4,4,6,14,10,10,8,obi
2025-04-06,IND,@,DEN,"W, 125-120",26:25,18,4,9,0,0,0,4,4,1,22,27,23,26,5,obi
2025-04-08,IND,,WAS,"W, 104-98",20:20,10,2,6,4,6,1,6,7,3,12,22,15,19,10,obi
2025-04-10,IND,,CLE,"W, 114-112",19:25,7,1,4,1,2,1,3,4,2,10,16,12,14,6,obi
2025-04-11,IND,,ORL,"L, 115-129",20:30,8,0,2,0,0,1,4,5,3,4,12,7,9,8,obi
2025-04-13,IND,@,CLE,"W, 126-118 (2OT)",12:15,6,1,3,0,0,1,2,3,0,7,10,7,10,3,obi
