Date,Team,Where,Opp,Result,MP,FGA,3P,3PA,FT,FTA,ORB,DRB,TRB,AST,PTS,PAR,PA,PR,AR,name
2024-10-22,MIN,@,LAL,"L, 103-110",20:13,7,0,5,3,3,2,2,4,2,5,11,7,9,6,mike
2024-10-24,MIN,@,SAC,"W, 117-115",27:20,9,2,7,0,0,1,1,2,4,6,12,10,8,6,mike
2024-10-26,MIN,,TOR,"W, 112-101",25:57,9,2,6,4,4,1,2,3,6,10,19,16,13,9,mike
2024-10-29,MIN,,DAL,"L, 114-120",21:35,6,2,4,3,3,1,3,4,6,9,19,15,13,10,mike
2024-11-01,MIN,,DEN,"W, 119-116",26:19,7,2,5,3,4,0,0,0,5,9,14,14,9,5,mike
2024-11-02,MIN,@,SAS,"L, 103-113",20:53,4,1,3,0,0,1,2,3,3,5,11,8,8,6,mike
2024-11-04,MIN,,CHO,"W, 114-93",23:20,8,3,5,0,0,1,4,5,4,11,20,15,16,9,mike
2024-11-07,MIN,@,CHI,"W, 135-119",26:15,9,3,6,1,1,0,2,2,11,14,27,25,16,13,mike
2024-11-08,MIN,,POR,"W, 127-102",18:18,7,0,4,0,0,0,1,1,2,2,5,4,3,3,mike
2024-11-10,MIN,,MIA,"L, 94-95",24:03,9,0,5,0,0,1,4,5,3,4,12,7,9,8,mike
2024-11-12,MIN,@,POR,"L, 108-122",24:17,5,2,5,0,0,0,4,4,6,6,16,12,10,10,mike
2024-11-15,MIN,@,SAC,"W, 130-126 (OT)",36:45,12,4,9,2,3,0,4,4,7,14,25,21,18,11,mike
2024-11-17,MIN,,PHO,"W, 120-117",30:05,2,1,1,0,1,0,4,4,3,3,10,6,7,7,mike
2024-11-27,MIN,,SAC,"L, 104-115",31:58,11,3,8,5,5,0,1,1,4,16,21,20,17,5,mike
2024-11-29,MIN,,LAC,"W, 93-92",33:04,7,3,5,4,4,0,2,2,3,13,18,16,15,5,mike
2024-12-02,MIN,,LAL,"W, 109-80",22:26,7,3,6,0,0,0,3,3,6,9,18,15,12,9,mike
2024-12-04,MIN,@,LAC,"W, 108-80",19:57,8,1,4,0,0,0,3,3,2,11,16,13,14,5,mike
2024-12-06,MIN,@,GSW,"W, 107-90",26:53,12,3,9,0,0,0,4,4,4,13,21,17,17,8,mike
2024-12-08,MIN,@,GSW,"L, 106-114",24:52,7,3,6,3,3,1,1,2,3,12,17,15,14,5,mike
2024-12-13,MIN,,LAL,"W, 97-87",28:53,6,0,4,2,2,0,4,4,7,2,13,9,6,11,mike
2024-12-15,MIN,@,SAS,"W, 106-92",27:55,9,3,5,0,0,3,2,5,8,9,22,17,14,13,mike
2024-12-19,MIN,,NYK,"L, 107-133",18:00,5,1,3,0,0,0,0,0,2,3,5,5,3,2,mike
2024-12-21,MIN,,GSW,"L, 103-113",25:26,6,1,5,0,0,0,2,2,5,3,10,8,5,7,mike
2024-12-23,MIN,@,ATL,"L, 104-117",27:11,6,3,5,0,0,0,2,2,6,11,19,17,13,8,mike
2024-12-25,MIN,@,DAL,"W, 105-99",25:39,9,1,5,1,1,0,2,2,3,10,15,13,12,5,mike
2024-12-27,MIN,@,HOU,"W, 113-112",23:39,5,1,4,0,0,1,1,2,2,3,7,5,5,4,mike
2024-12-29,MIN,,SAS,"W, 112-110",22:50,5,1,4,2,2,0,2,2,3,5,10,8,7,5,mike
2024-12-31,MIN,@,OKC,"L, 105-113",23:19,10,4,7,2,2,1,0,1,4,16,21,20,17,5,mike
2025-01-02,MIN,,BOS,"L, 115-118",18:58,4,1,2,0,0,1,1,2,3,5,10,8,7,5,mike
2025-01-04,MIN,@,DET,"L, 105-119",21:09,4,0,3,0,0,0,0,0,5,0,5,5,0,5,mike
2025-01-06,MIN,,LAC,"W, 108-106",26:24,8,2,3,1,1,1,3,4,3,11,18,14,15,7,mike
2025-01-07,MIN,@,NOP,"W, 104-97",24:44,4,1,3,3,4,1,3,4,6,8,18,14,12,10,mike
2025-01-09,MIN,@,ORL,"W, 104-89",23:04,7,1,2,2,2,0,4,4,2,9,15,11,13,6,mike
2025-01-11,MIN,,MEM,"L, 125-127",15:20,4,1,3,0,0,0,0,0,2,3,5,5,3,2,mike
2025-01-13,MIN,@,WAS,"W, 120-106",20:19,3,1,2,4,5,0,5,5,4,7,16,11,12,9,mike
2025-01-15,MIN,,GSW,"L, 115-116",18:31,3,0,2,1,2,0,0,0,3,1,4,4,1,3,mike
2025-01-17,MIN,@,NYK,"W, 116-99",24:42,9,3,5,0,0,0,0,0,2,13,15,15,13,2,mike
2025-01-18,MIN,,CLE,"L, 117-124",22:36,7,3,6,0,0,1,2,3,3,9,15,12,12,6,mike
2025-01-20,MIN,@,MEM,"L, 106-108",25:20,6,1,4,2,2,1,3,4,8,5,17,13,9,12,mike
2025-01-22,MIN,@,DAL,"W, 115-114",32:00,9,4,6,2,2,1,4,5,8,18,31,26,23,13,mike
2025-01-25,MIN,,DEN,"W, 133-104",22:37,3,3,3,0,0,0,1,1,5,9,15,14,10,6,mike
2025-01-27,MIN,,ATL,"W, 100-92",31:22,9,0,5,2,2,1,3,4,4,4,12,8,8,8,mike
2025-01-29,MIN,@,PHO,"W, 121-113",30:01,4,2,3,0,0,0,0,0,6,6,12,12,6,6,mike
2025-02-01,MIN,,WAS,"L, 103-105",34:04,12,2,7,4,4,0,3,3,5,16,24,21,19,8,mike
2025-02-03,MIN,,SAC,"L, 114-116",26:34,8,1,3,0,0,1,2,3,9,5,17,14,8,12,mike
2025-02-05,MIN,,CHI,"W, 127-108",25:38,10,2,7,2,2,2,3,5,9,8,22,17,13,14,mike
2025-02-06,MIN,,HOU,"W, 127-114",28:31,8,4,4,0,0,0,3,3,5,16,24,21,19,8,mike
2025-02-21,MIN,@,HOU,"L, 115-121",23:59,2,0,2,5,5,0,2,2,5,5,12,10,7,7,mike
2025-02-23,MIN,,OKC,"L, 123-130",31:27,6,3,6,0,0,0,2,2,5,9,16,14,11,7,mike
2025-02-24,MIN,@,OKC,"W, 131-128 (OT)",14:07,5,2,4,0,0,0,0,0,1,8,9,9,8,1,mike
2025-02-27,MIN,@,LAL,"L, 102-111",25:37,5,2,4,2,2,1,0,1,4,10,15,14,11,5,mike
2025-02-28,MIN,@,UTA,"L, 116-117",23:33,5,1,4,0,0,0,1,1,6,3,10,9,4,7,mike
2025-03-02,MIN,@,PHO,"W, 116-98",19:52,3,1,2,0,0,0,1,1,1,3,5,4,4,2,mike
2025-03-04,MIN,,PHI,"W, 126-112",24:31,6,3,5,1,1,1,6,7,6,12,25,18,19,13,mike
2025-03-07,MIN,@,MIA,"W, 106-104",24:38,9,3,5,0,0,1,1,2,2,15,19,17,17,4,mike
2025-03-09,MIN,,SAS,"W, 141-124",23:20,8,3,5,2,2,0,5,5,5,13,23,18,18,10,mike
2025-03-12,MIN,@,DEN,"W, 115-95",20:23,5,1,2,1,1,1,0,1,5,8,14,13,9,6,mike
2025-03-14,MIN,,ORL,"W, 118-111",24:26,6,3,5,0,0,0,1,1,3,9,13,12,10,4,mike
2025-03-17,MIN,,IND,"L, 130-132 (OT)",31:48,3,2,2,3,4,0,3,3,5,9,17,14,12,8,mike
2025-03-19,MIN,,NOP,"L, 115-119",28:20,8,4,6,0,0,0,2,2,2,16,20,18,18,4,mike
2025-03-21,MIN,,NOP,"W, 134-93",10:21,1,0,1,0,0,0,1,1,6,0,7,6,1,7,mike
2025-03-24,MIN,@,IND,"L, 103-119",21:59,5,1,2,0,0,0,4,4,5,7,16,12,11,9,mike
2025-03-28,MIN,,PHO,"W, 124-109",29:42,10,3,7,0,0,0,3,3,4,13,20,17,16,7,mike
2025-03-30,MIN,,DET,"W, 123-104",29:43,9,2,2,5,7,1,1,2,2,17,21,19,19,4,mike
2025-04-01,MIN,@,DEN,"W, 140-139 (2OT)",36:27,8,3,7,0,0,1,0,1,8,9,18,17,10,9,mike
2025-04-03,MIN,@,BRK,"W, 105-90",24:22,10,2,7,0,0,0,1,1,6,6,13,12,7,7,mike
2025-04-05,MIN,@,PHI,"W, 114-109",24:58,7,2,4,0,0,0,4,4,4,8,16,12,12,8,mike
2025-04-08,MIN,@,MIL,"L, 103-110",27:48,6,1,3,0,0,1,3,4,3,5,12,8,9,7,mike
2025-04-10,MIN,@,MEM,"W, 141-125",26:38,7,0,4,4,4,1,1,2,9,8,19,17,10,11,mike
2025-04-11,MIN,,BRK,"W, 117-91",13:36,2,0,1,0,0,0,4,4,4,2,10,6,6,8,mike
2025-04-13,MIN,,UTA,"W, 116-105",14:58,3,0,2,0,0,0,2,2,2,0,4,2,2,4,mike
