Date,Team,Where,Opp,Result,MP,FGA,3P,3PA,FT,FTA,ORB,DRB,TRB,AST,PTS,PAR,PA,PR,AR,name
2024-10-22,NYK,@,BOS,"L, 109-132",34:37,13,2,7,0,1,0,0,0,2,16,18,18,16,2,mikal
2024-10-25,NYK,,IND,"W, 123-98",33:29,12,2,3,3,4,1,0,1,5,21,27,26,22,6,mikal
2024-10-28,NYK,,CLE,"L, 104-110",40:10,15,1,4,0,0,4,2,6,3,19,28,22,25,9,mikal
2024-10-30,NYK,@,MIA,"W, 116-107",39:51,16,4,11,1,2,1,2,3,6,17,26,23,20,9,mikal
2024-11-01,NYK,@,DET,"W, 128-98",34:40,13,3,6,0,0,0,7,7,3,15,25,18,22,10,mikal
2024-11-04,NYK,@,HOU,"L, 97-109",40:21,14,3,8,0,1,1,2,3,0,15,18,15,18,3,mikal
2024-11-06,NYK,@,ATL,"L, 116-121",38:38,10,2,7,0,0,0,2,2,5,10,17,15,12,7,mikal
2024-11-08,NYK,,MIL,"W, 116-94",36:32,18,3,11,0,0,1,2,3,3,17,23,20,20,6,mikal
2024-11-10,NYK,@,IND,"L, 121-132",41:32,11,0,6,0,0,3,4,7,4,8,19,12,15,11,mikal
2024-11-12,NYK,@,PHI,"W, 111-99",35:22,13,0,2,0,0,1,3,4,3,14,21,17,18,7,mikal
2024-11-13,NYK,,CHI,"L, 123-124",42:58,15,1,4,3,3,0,6,6,5,20,31,25,26,11,mikal
2024-11-15,NYK,,BRK,"W, 124-122",41:11,17,4,7,0,0,2,3,5,4,22,31,26,27,9,mikal
2024-11-17,NYK,,BRK,"W, 114-104",44:57,18,3,10,0,0,2,4,6,1,21,28,22,27,7,mikal
2024-11-18,NYK,,WAS,"W, 134-106",34:42,14,0,4,0,0,2,1,3,5,14,22,19,17,8,mikal
2024-11-20,NYK,@,PHO,"W, 138-122",40:04,14,2,5,0,0,0,3,3,5,16,24,21,19,8,mikal
2024-11-23,NYK,@,UTA,"L, 106-121",32:36,15,1,7,0,0,0,3,3,0,7,10,7,10,3,mikal
2024-11-25,NYK,@,DEN,"W, 145-118",36:11,16,2,8,0,0,0,2,2,6,14,22,20,16,8,mikal
2024-11-27,NYK,@,DAL,"L, 114-129",39:15,19,4,10,0,0,2,3,5,0,20,25,20,25,5,mikal
2024-11-29,NYK,@,CHO,"W, 99-98",36:40,10,1,4,1,2,1,1,2,2,8,12,10,10,4,mikal
2024-12-01,NYK,,NOP,"W, 118-85",35:30,19,7,12,0,0,0,4,4,1,31,36,32,35,5,mikal
2024-12-03,NYK,,ORL,"W, 121-106",35:32,13,2,6,1,1,0,2,2,5,19,26,24,21,7,mikal
2024-12-05,NYK,,CHO,"W, 125-101",46:30,15,2,7,3,5,0,3,3,7,19,29,26,22,10,mikal
2024-12-07,NYK,,DET,"L, 111-120",37:49,17,3,9,1,2,1,2,3,3,20,26,23,23,6,mikal
2024-12-09,NYK,@,TOR,"W, 113-108",41:15,14,5,8,0,0,0,3,3,3,23,29,26,26,6,mikal
2024-12-11,NYK,,ATL,"L, 100-108",37:41,17,1,5,0,0,2,2,4,2,19,25,21,23,6,mikal
2024-12-15,NYK,@,ORL,"W, 100-91",40:49,11,1,3,2,2,0,1,1,1,17,19,18,18,2,mikal
2024-12-19,NYK,@,MIN,"W, 133-107",35:36,18,4,8,1,1,2,4,6,6,29,41,35,35,12,mikal
2024-12-21,NYK,@,NOP,"W, 104-93",45:01,16,3,6,1,2,0,0,0,2,18,20,20,18,2,mikal
2024-12-23,NYK,,TOR,"W, 139-125",40:41,10,4,8,0,0,0,1,1,4,14,19,18,15,5,mikal
2024-12-25,NYK,,SAS,"W, 117-114",43:15,25,6,9,1,1,1,0,1,4,41,46,45,42,5,mikal
2024-12-27,NYK,@,ORL,"W, 108-85",43:31,12,0,1,5,6,0,2,2,3,17,22,20,19,5,mikal
2024-12-28,NYK,@,WAS,"W, 136-132 (OT)",46:39,14,3,9,2,2,1,2,3,3,21,27,24,24,6,mikal
2024-12-30,NYK,@,WAS,"W, 126-106",35:48,15,1,6,0,0,2,4,6,6,13,25,19,19,12,mikal
2025-01-01,NYK,,UTA,"W, 119-103",44:29,17,2,5,1,2,0,1,1,0,27,28,27,28,1,mikal
2025-01-03,NYK,@,OKC,"L, 107-117",40:59,19,4,11,0,0,1,2,3,2,24,29,26,27,5,mikal
2025-01-04,NYK,@,CHI,"L, 126-139",33:16,18,0,5,2,3,3,0,3,1,18,22,19,21,4,mikal
2025-01-06,NYK,,ORL,"L, 94-103",42:23,20,1,7,3,4,0,5,5,2,24,31,26,29,7,mikal
2025-01-08,NYK,,TOR,"W, 112-98",35:47,18,2,11,0,0,1,2,3,3,10,16,13,13,6,mikal
2025-01-10,NYK,,OKC,"L, 101-126",31:49,9,0,7,0,0,0,1,1,2,0,3,2,1,3,mikal
2025-01-12,NYK,,MIL,"W, 140-106",37:18,5,1,4,1,2,1,1,2,6,6,14,12,8,8,mikal
2025-01-13,NYK,,DET,"L, 119-124",37:01,13,6,8,3,3,1,1,2,1,27,30,28,29,3,mikal
2025-01-15,NYK,@,PHI,"W, 125-119 (OT)",43:28,19,5,10,0,0,0,2,2,2,23,27,25,25,4,mikal
2025-01-17,NYK,,MIN,"L, 99-116",38:45,17,3,7,0,0,3,1,4,5,15,24,20,19,9,mikal
2025-01-20,NYK,,ATL,"W, 119-110",27:26,17,1,2,1,1,1,0,1,4,26,31,30,27,5,mikal
2025-01-21,NYK,@,BRK,"W, 99-95",34:23,13,2,6,2,2,0,1,1,2,10,13,12,11,3,mikal
2025-01-25,NYK,,SAC,"W, 143-120",34:31,15,5,7,2,2,1,4,5,7,27,39,34,32,12,mikal
2025-01-27,NYK,,MEM,"W, 143-106",33:37,19,2,6,2,2,1,4,5,6,28,39,34,33,11,mikal
2025-01-29,NYK,,DEN,"W, 122-112",37:06,16,3,7,0,0,0,3,3,2,13,18,15,16,5,mikal
2025-02-01,NYK,,LAL,"L, 112-128",33:06,14,2,4,0,0,1,1,2,3,16,21,19,18,5,mikal
2025-02-03,NYK,,HOU,"W, 124-118",39:17,18,2,7,2,4,1,2,3,4,22,29,26,25,7,mikal
2025-02-04,NYK,@,TOR,"W, 121-115",41:11,13,1,4,2,2,0,2,2,2,17,21,19,19,4,mikal
2025-02-08,NYK,,BOS,"L, 104-131",34:02,15,1,3,0,0,1,2,3,2,11,16,13,14,5,mikal
2025-02-11,NYK,@,IND,"W, 128-115",28:53,7,0,1,0,0,1,4,5,5,6,16,11,11,10,mikal
2025-02-12,NYK,,ATL,"W, 149-148 (OT)",42:56,8,1,2,0,0,0,3,3,4,11,18,15,14,7,mikal
2025-02-20,NYK,,CHI,"W, 113-111 (OT)",43:32,16,1,5,0,0,4,6,10,5,13,28,18,23,15,mikal
2025-02-21,NYK,@,CLE,"L, 105-142",29:12,13,2,5,0,0,1,0,1,5,14,20,19,15,6,mikal
2025-02-23,NYK,@,BOS,"L, 105-118",27:43,13,2,6,0,0,0,0,0,1,14,15,15,14,1,mikal
2025-02-26,NYK,,PHI,"W, 110-105",41:22,18,3,5,1,2,0,2,2,3,28,33,31,30,5,mikal
2025-02-28,NYK,@,MEM,"W, 114-113",33:29,14,0,5,1,2,0,2,2,3,15,20,18,17,5,mikal
2025-03-02,NYK,@,MIA,"W, 116-112 (OT)",28:29,11,1,6,0,0,1,3,4,8,5,17,13,9,12,mikal
2025-03-04,NYK,,GSW,"L, 102-114",35:42,15,1,5,0,0,1,3,4,4,15,23,19,19,8,mikal
2025-03-06,NYK,@,LAL,"L, 109-113 (OT)",43:01,6,0,1,0,0,1,2,3,3,6,12,9,9,6,mikal
2025-03-07,NYK,@,LAC,"L, 95-105",42:35,12,0,1,6,6,2,2,4,5,22,31,27,26,9,mikal
2025-03-10,NYK,@,SAC,"W, 133-104",33:31,10,1,3,2,2,1,2,3,8,15,26,23,18,11,mikal
2025-03-12,NYK,@,POR,"W, 114-113 (OT)",40:43,21,2,4,5,6,0,4,4,4,33,41,37,37,8,mikal
2025-03-15,NYK,@,GSW,"L, 94-97",38:02,14,1,3,2,2,0,6,6,3,19,28,22,25,9,mikal
2025-03-17,NYK,,MIA,"W, 116-95",32:20,14,4,6,4,4,0,1,1,3,28,32,31,29,4,mikal
2025-03-19,NYK,@,SAS,"L, 105-120",32:18,13,1,4,3,3,3,2,5,7,14,26,21,19,12,mikal
2025-03-20,NYK,@,CHO,"L, 98-115",32:41,11,0,4,6,8,0,4,4,6,16,26,22,20,10,mikal
2025-03-22,NYK,,WAS,"W, 122-103",37:34,20,4,8,3,3,3,3,6,4,27,37,31,33,10,mikal
2025-03-25,NYK,,DAL,"W, 128-113",33:46,14,2,4,1,1,0,1,1,1,21,23,22,22,2,mikal
2025-03-26,NYK,,LAC,"L, 113-126",39:56,16,1,5,2,2,0,4,4,9,17,30,26,21,13,mikal
2025-03-28,NYK,@,MIL,"W, 116-107",37:53,24,2,6,0,0,0,3,3,5,26,34,31,29,8,mikal
2025-03-30,NYK,,POR,"W, 110-93",39:34,22,2,6,2,2,0,2,2,7,28,37,35,30,9,mikal
2025-04-01,NYK,,PHI,"W, 105-91",36:29,16,2,6,0,0,1,1,2,4,14,20,18,16,6,mikal
2025-04-02,NYK,@,CLE,"L, 105-124",35:49,6,0,1,2,2,1,1,2,3,8,13,11,10,5,mikal
2025-04-05,NYK,@,ATL,"W, 121-105",32:31,13,2,3,0,0,1,2,3,5,20,28,25,23,8,mikal
2025-04-06,NYK,,PHO,"W, 112-98",39:27,14,2,3,4,4,0,6,6,4,22,32,26,28,10,mikal
2025-04-08,NYK,,BOS,"L, 117-119 (OT)",37:48,15,2,6,0,0,1,3,4,4,14,22,18,18,8,mikal
2025-04-10,NYK,@,DET,"L, 106-115",32:58,10,1,2,2,2,1,1,2,7,17,26,24,19,9,mikal
2025-04-11,NYK,,CLE,"L, 102-108",36:24,13,1,5,4,5,2,0,2,8,17,27,25,19,10,mikal
2025-04-13,NYK,@,BRK,"W, 113-105",00:06,0,0,0,0,0,0,0,0,0,0,0,0,0,0,mikal
