Date,Team,Where,Opp,Result,MP,FGA,3P,3PA,FT,FTA,ORB,DRB,TRB,AST,PTS,PAR,PA,PR,AR,name
2024-10-23,PHO,@,LAC,"W, 116-113 (OT)",21:23,7,2,6,2,2,0,1,1,3,8,12,11,9,4,grayson
2024-10-28,PHO,,LAL,"W, 109-105",12:18,2,1,2,0,0,1,1,2,0,3,5,3,5,2,grayson
2024-10-31,PHO,@,LAC,"W, 125-119",18:55,8,0,5,0,0,0,5,5,3,2,10,5,7,8,grayson
2024-11-02,PHO,,POR,"W, 103-97",18:32,12,4,7,0,0,1,1,2,0,18,20,18,20,2,grayson
2024-11-04,PHO,,PHI,"W, 118-116",23:42,6,2,4,6,6,1,1,2,0,14,16,14,16,2,grayson
2024-11-06,PHO,,MIA,"W, 115-112",21:39,10,3,9,3,4,0,2,2,0,12,14,12,14,2,grayson
2024-11-08,PHO,@,DAL,"W, 114-113",18:34,4,0,3,0,0,2,1,3,0,0,3,0,3,3,grayson
2024-11-10,PHO,,SAC,"L, 118-127 (OT)",26:41,13,3,11,0,0,0,1,1,3,9,13,12,10,4,grayson
2024-11-12,PHO,@,UTA,"W, 120-112",25:35,10,4,9,1,2,0,1,1,0,15,16,15,16,1,grayson
2024-11-17,PHO,@,MIN,"L, 117-120",24:10,10,4,7,2,2,1,4,5,1,18,24,19,23,6,grayson
2024-11-18,PHO,,ORL,"L, 99-109",29:24,10,4,9,3,7,0,4,4,1,17,22,18,21,5,grayson
2024-11-20,PHO,,NYK,"L, 122-138",20:41,9,1,8,3,3,0,1,1,1,8,10,9,9,2,grayson
2024-11-26,PHO,,LAL,"W, 127-100",22:35,10,2,6,0,0,1,1,2,2,10,14,12,12,4,grayson
2024-11-27,PHO,,BRK,"L, 117-127",30:08,8,1,4,0,1,0,5,5,1,9,15,10,14,6,grayson
2024-11-30,PHO,,GSW,"W, 113-105",32:27,8,3,6,6,6,1,3,4,3,17,24,20,21,7,grayson
2024-12-03,PHO,,SAS,"W, 104-93",23:38,5,0,3,4,4,0,3,3,3,8,14,11,11,6,grayson
2024-12-05,PHO,@,NOP,"L, 124-126",29:53,7,3,5,2,2,0,6,6,10,13,29,23,19,16,grayson
2024-12-07,PHO,@,MIA,"L, 111-121",30:15,10,5,9,1,2,1,1,2,4,16,22,20,18,6,grayson
2024-12-08,PHO,@,ORL,"L, 110-115",22:24,3,2,2,5,5,1,3,4,2,13,19,15,17,6,grayson
2024-12-13,PHO,@,UTA,"W, 134-126",24:37,8,2,5,0,0,1,3,4,2,8,14,10,12,6,grayson
2024-12-15,PHO,,POR,"W, 116-109",23:44,13,4,9,0,0,1,1,2,1,12,15,13,14,3,grayson
2024-12-19,PHO,,IND,"L, 111-120",29:29,9,0,3,2,2,3,7,10,0,8,18,8,18,10,grayson
2024-12-21,PHO,,DET,"L, 125-133",19:44,1,0,1,2,2,1,2,3,2,2,7,4,5,5,grayson
2025-01-04,PHO,@,IND,"L, 108-126",30:39,10,3,7,0,0,0,4,4,6,13,23,19,17,10,grayson
2025-01-06,PHO,@,PHI,"W, 109-99",14:27,3,1,1,1,2,0,1,1,0,6,7,6,7,1,grayson
2025-01-07,PHO,@,CHO,"L, 104-115",25:04,7,3,6,0,0,1,2,3,0,9,12,9,12,3,grayson
2025-01-09,PHO,,ATL,"W, 123-115",26:55,8,5,6,4,4,0,2,2,1,23,26,24,25,3,grayson
2025-01-11,PHO,,UTA,"W, 114-106",30:28,11,4,10,0,0,0,4,4,4,14,22,18,18,8,grayson
2025-01-12,PHO,,CHO,"W, 120-113",13:24,7,3,6,2,2,0,1,1,0,13,14,13,14,1,grayson
2025-01-14,PHO,@,ATL,"L, 117-122",26:39,4,3,4,0,0,0,4,4,2,9,15,11,13,6,grayson
2025-01-16,PHO,@,WAS,"W, 130-123",28:06,12,5,7,0,0,0,5,5,0,21,26,21,26,5,grayson
2025-01-18,PHO,@,DET,"W, 125-121",29:23,4,1,2,4,4,1,2,3,3,7,13,10,10,6,grayson
2025-01-20,PHO,@,CLE,"L, 92-118",26:51,5,2,4,2,3,0,3,3,2,10,15,12,13,5,grayson
2025-01-22,PHO,@,BRK,"W, 108-84",24:03,6,2,5,2,2,1,1,2,4,8,14,12,10,6,grayson
2025-01-25,PHO,,WAS,"W, 119-109",25:16,9,2,7,0,0,2,2,4,1,8,13,9,12,5,grayson
2025-01-27,PHO,,LAC,"W, 111-109",27:40,10,4,7,2,4,0,6,6,0,18,24,18,24,6,grayson
2025-01-29,PHO,,MIN,"L, 113-121",28:51,7,3,6,0,0,2,5,7,1,11,19,12,18,8,grayson
2025-01-31,PHO,@,GSW,"W, 130-105",23:27,6,3,5,0,0,0,6,6,7,11,24,18,17,13,grayson
2025-02-01,PHO,@,POR,"L, 108-127",22:55,3,1,3,0,0,1,3,4,2,3,9,5,7,6,grayson
2025-02-03,PHO,@,POR,"L, 119-121 (OT)",34:04,9,3,8,0,0,1,2,3,2,11,16,13,14,5,grayson
2025-02-05,PHO,@,OKC,"L, 109-140",29:44,9,3,7,0,0,0,2,2,3,9,14,12,11,5,grayson
2025-02-07,PHO,,UTA,"W, 135-127 (OT)",35:40,19,7,14,0,0,2,5,7,6,21,34,27,28,13,grayson
2025-02-11,PHO,,MEM,"L, 112-119",19:38,7,1,4,2,2,0,0,0,3,9,12,12,9,3,grayson
2025-02-20,PHO,@,SAS,"L, 109-120",32:56,10,3,9,2,2,0,2,2,3,11,16,14,13,5,grayson
2025-02-22,PHO,@,CHI,"W, 121-117",24:20,4,0,1,1,2,0,3,3,4,3,10,7,6,7,grayson
2025-02-23,PHO,@,TOR,"L, 109-127",23:30,6,1,2,0,0,1,3,4,1,9,14,10,13,5,grayson
2025-02-25,PHO,@,MEM,"L, 148-151 (OT)",29:48,10,6,9,3,5,0,3,3,3,21,27,24,24,6,grayson
2025-02-27,PHO,,NOP,"L, 116-124",15:50,7,0,6,0,0,0,1,1,2,0,3,2,1,3,grayson
2025-03-02,PHO,,MIN,"L, 98-116",14:55,4,1,4,2,2,0,2,2,1,5,8,6,7,3,grayson
2025-03-04,PHO,,LAC,"W, 119-117",23:59,3,2,2,0,0,0,3,3,2,8,13,10,11,5,grayson
2025-03-07,PHO,@,DEN,"L, 141-149 (OT)",29:07,4,2,2,3,5,0,0,0,4,11,15,15,11,4,grayson
2025-03-09,PHO,@,DAL,"W, 125-116",23:16,10,3,6,2,2,0,1,1,4,17,22,21,18,5,grayson
2025-03-10,PHO,@,MEM,"L, 118-120",25:28,5,2,4,3,4,1,0,1,3,9,13,12,10,4,grayson
2025-03-24,PHO,,MIL,"W, 108-106",11:47,5,1,5,0,0,0,2,2,0,3,5,3,5,2,grayson
2025-03-26,PHO,,BOS,"L, 102-132",14:15,3,0,2,2,3,0,1,1,1,2,4,3,3,2,grayson
2025-03-28,PHO,@,MIN,"L, 109-124",12:12,1,1,1,0,0,0,2,2,0,3,5,3,5,2,grayson
2025-03-30,PHO,,HOU,"L, 109-148",18:19,5,1,2,2,2,0,0,0,2,7,9,9,7,2,grayson
2025-04-01,PHO,@,MIL,"L, 123-133",33:49,17,6,13,1,2,2,2,4,3,23,30,26,27,7,grayson
2025-04-04,PHO,@,BOS,"L, 103-123",16:30,6,1,3,1,1,0,1,1,1,8,10,9,9,2,grayson
2025-04-06,PHO,@,NYK,"L, 98-112",21:59,13,0,6,7,7,0,6,6,1,15,22,16,21,7,grayson
2025-04-08,PHO,,GSW,"L, 95-133",18:27,9,3,6,1,2,1,0,1,1,12,14,13,13,2,grayson
2025-04-09,PHO,,OKC,"L, 112-125",23:04,6,0,2,0,0,1,3,4,1,4,9,5,8,5,grayson
2025-04-11,PHO,,SAS,"W, 117-98",28:52,9,3,6,2,2,1,5,6,6,15,27,21,21,12,grayson
2025-04-13,PHO,@,SAC,"L, 98-109",27:41,13,4,7,0,0,0,2,2,5,20,27,25,22,7,grayson
