Date,Team,Where,Opp,Result,MP,FGA,3P,3PA,FT,FTA,ORB,DRB,TRB,AST,PTS,PAR,PA,PR,AR,name
2024-10-23,PHO,@,LAC,"W, 116-113 (OT)",08:44,5,0,2,0,0,0,2,2,1,2,5,3,4,3,ryan
2024-10-25,PHO,@,LAL,"L, 116-123",13:31,5,3,5,0,0,0,3,3,1,9,13,10,12,4,ryan
2024-10-26,PHO,,DAL,"W, 114-102",21:10,8,3,6,0,0,1,0,1,1,13,15,14,14,2,ryan
2024-10-28,PHO,,LAL,"W, 109-105",15:22,5,1,3,0,0,0,1,1,0,7,8,7,8,1,ryan
2024-10-31,PHO,@,LAC,"W, 125-119",34:18,12,4,9,0,0,1,3,4,0,16,20,16,20,4,ryan
2024-11-02,PHO,,POR,"W, 103-97",13:42,4,0,3,0,0,1,1,2,2,0,4,2,2,4,ryan
2024-11-04,PHO,,PHI,"W, 118-116",10:27,3,0,3,0,0,0,4,4,1,0,5,1,4,5,ryan
2024-11-06,PHO,,MIA,"W, 115-112",09:28,2,2,2,1,2,0,1,1,1,7,9,8,8,2,ryan
2024-11-10,PHO,,SAC,"L, 118-127 (OT)",21:15,7,0,3,0,0,0,2,2,0,8,10,8,10,2,ryan
2024-11-12,PHO,@,UTA,"W, 120-112",19:52,5,2,2,0,0,0,3,3,0,8,11,8,11,3,ryan
2024-11-13,PHO,@,SAC,"L, 104-127",27:43,11,2,7,0,2,2,1,3,1,10,14,11,13,4,ryan
2024-11-15,PHO,@,OKC,"L, 83-99",24:59,13,1,9,0,0,0,5,5,0,9,14,9,14,5,ryan
2024-11-17,PHO,@,MIN,"L, 117-120",18:28,2,0,1,0,2,0,0,0,0,2,2,2,2,0,ryan
2024-11-18,PHO,,ORL,"L, 99-109",21:16,8,1,4,0,0,4,2,6,1,5,12,6,11,7,ryan
2024-11-20,PHO,,NYK,"L, 122-138",21:40,7,2,4,0,0,2,0,2,3,8,13,11,10,5,ryan
2024-11-26,PHO,,LAL,"W, 127-100",15:17,6,1,4,0,0,1,3,4,1,5,10,6,9,5,ryan
2024-11-27,PHO,,BRK,"L, 117-127",09:08,2,0,2,0,0,0,0,0,0,0,0,0,0,0,ryan
2024-11-30,PHO,,GSW,"W, 113-105",20:17,2,0,1,0,0,0,4,4,2,2,8,4,6,6,ryan
2024-12-03,PHO,,SAS,"W, 104-93",12:03,3,0,1,1,2,0,4,4,0,3,7,3,7,4,ryan
2024-12-13,PHO,@,UTA,"W, 134-126",13:18,6,2,3,1,2,0,1,1,0,13,14,13,14,1,ryan
2024-12-15,PHO,,POR,"W, 116-109",14:44,3,0,2,2,2,1,1,2,0,4,6,4,6,2,ryan
2024-12-19,PHO,,IND,"L, 111-120",11:40,3,0,1,0,0,0,0,0,1,2,3,3,2,1,ryan
2024-12-21,PHO,,DET,"L, 125-133",14:22,4,1,3,0,0,0,2,2,1,5,8,6,7,3,ryan
2024-12-23,PHO,@,DEN,"L, 90-117",30:12,6,1,4,0,0,1,3,4,2,5,11,7,9,6,ryan
2024-12-25,PHO,,DEN,"W, 110-100",20:51,3,1,2,0,0,2,1,3,1,5,9,6,8,4,ryan
2024-12-27,PHO,,DAL,"L, 89-98",21:12,8,1,5,0,0,1,4,5,1,5,11,6,10,6,ryan
2024-12-28,PHO,@,GSW,"L, 105-109",26:30,12,1,6,2,2,2,2,4,1,15,20,16,19,5,ryan
2024-12-31,PHO,,MEM,"L, 112-117",34:57,7,2,5,0,0,3,6,9,3,8,20,11,17,12,ryan
2025-01-04,PHO,@,IND,"L, 108-126",29:31,11,1,4,0,0,1,3,4,1,13,18,14,17,5,ryan
2025-01-06,PHO,@,PHI,"W, 109-99",27:03,11,3,6,0,0,0,4,4,1,15,20,16,19,5,ryan
2025-01-07,PHO,@,CHO,"L, 104-115",25:20,8,0,4,0,0,1,3,4,0,6,10,6,10,4,ryan
2025-01-09,PHO,,ATL,"W, 123-115",16:23,5,0,0,0,0,2,5,7,0,6,13,6,13,7,ryan
2025-01-11,PHO,,UTA,"W, 114-106",23:53,8,1,3,1,2,2,3,5,2,10,17,12,15,7,ryan
2025-01-12,PHO,,CHO,"W, 120-113",27:22,5,3,4,0,0,3,3,6,2,11,19,13,17,8,ryan
2025-01-14,PHO,@,ATL,"L, 117-122",21:37,12,1,4,1,3,1,0,1,0,14,15,14,15,1,ryan
2025-01-16,PHO,@,WAS,"W, 130-123",29:43,12,2,3,0,0,2,9,11,1,18,30,19,29,12,ryan
2025-01-18,PHO,@,DET,"W, 125-121",29:18,13,2,5,0,0,4,4,8,1,12,21,13,20,9,ryan
2025-01-20,PHO,@,CLE,"L, 92-118",20:29,7,0,2,0,0,1,2,3,1,4,8,5,7,4,ryan
2025-01-22,PHO,@,BRK,"W, 108-84",22:51,8,0,2,0,0,0,2,2,3,6,11,9,8,5,ryan
2025-01-25,PHO,,WAS,"W, 119-109",01:49,1,0,0,1,2,1,0,1,0,1,2,1,2,1,ryan
2025-01-29,PHO,,MIN,"L, 113-121",09:26,6,1,2,0,0,3,1,4,2,5,11,7,9,6,ryan
2025-01-31,PHO,@,GSW,"W, 130-105",12:33,5,0,1,0,0,0,1,1,2,4,7,6,5,3,ryan
2025-02-01,PHO,@,POR,"L, 108-127",20:09,2,0,1,0,0,2,3,5,1,2,8,3,7,6,ryan
2025-02-03,PHO,@,POR,"L, 119-121 (OT)",12:25,1,0,0,0,0,0,4,4,0,0,4,0,4,4,ryan
2025-02-05,PHO,@,OKC,"L, 109-140",11:09,4,0,3,0,0,0,5,5,0,2,7,2,7,5,ryan
2025-02-07,PHO,,UTA,"W, 135-127 (OT)",14:34,4,1,2,1,2,1,2,3,0,6,9,6,9,3,ryan
2025-02-08,PHO,,DEN,"L, 105-122",13:25,7,2,5,0,0,2,0,2,1,8,11,9,10,3,ryan
2025-02-11,PHO,,MEM,"L, 112-119",04:51,0,0,0,0,0,0,1,1,0,0,1,0,1,1,ryan
2025-02-12,PHO,@,HOU,"L, 111-119",09:55,2,0,2,0,0,0,2,2,0,0,2,0,2,2,ryan
2025-02-20,PHO,@,SAS,"L, 109-120",00:20,0,0,0,0,0,0,0,0,0,0,0,0,0,0,ryan
2025-02-23,PHO,@,TOR,"L, 109-127",06:51,3,0,2,0,0,0,1,1,0,0,1,0,1,1,ryan
2025-02-25,PHO,@,MEM,"L, 148-151 (OT)",06:11,1,0,0,0,0,1,0,1,0,0,1,0,1,1,ryan
2025-02-27,PHO,,NOP,"L, 116-124",13:33,5,0,3,0,0,1,1,2,0,0,2,0,2,2,ryan
2025-02-28,PHO,,NOP,"W, 125-108",16:51,2,1,1,0,2,1,1,2,0,5,7,5,7,2,ryan
2025-03-02,PHO,,MIN,"L, 98-116",10:46,6,1,5,0,0,1,2,3,1,5,9,6,8,4,ryan
2025-03-09,PHO,@,DAL,"W, 125-116",01:30,0,0,0,0,0,0,1,1,0,0,1,0,1,1,ryan
2025-03-10,PHO,@,MEM,"L, 118-120",00:27,0,0,0,0,0,0,0,0,0,0,0,0,0,0,ryan
2025-03-12,PHO,@,HOU,"L, 104-111",16:47,3,1,2,1,2,0,2,2,0,4,6,4,6,2,ryan
2025-03-14,PHO,,SAC,"W, 122-106",33:29,16,2,9,2,2,2,3,5,3,16,24,19,21,8,ryan
2025-03-16,PHO,@,LAL,"L, 96-107",23:13,12,2,8,1,2,0,3,3,1,13,17,14,16,4,ryan
2025-03-17,PHO,,TOR,"W, 129-89",24:19,16,3,7,0,0,3,3,6,0,17,23,17,23,6,ryan
2025-03-19,PHO,,CHI,"W, 127-121",29:30,11,2,4,0,1,1,4,5,0,16,21,16,21,5,ryan
2025-03-21,PHO,,CLE,"W, 123-112",26:20,9,2,5,0,0,3,6,9,1,10,20,11,19,10,ryan
2025-03-24,PHO,,MIL,"W, 108-106",29:36,7,2,4,0,1,3,6,9,0,12,21,12,21,9,ryan
2025-03-26,PHO,,BOS,"L, 102-132",21:43,9,2,6,0,2,3,2,5,0,6,11,6,11,5,ryan
2025-03-28,PHO,@,MIN,"L, 109-124",22:11,5,3,5,0,0,1,2,3,1,9,13,10,12,4,ryan
2025-03-30,PHO,,HOU,"L, 109-148",19:24,3,0,2,0,0,2,0,2,0,2,4,2,4,2,ryan
2025-04-01,PHO,@,MIL,"L, 123-133",22:42,7,1,5,0,0,0,3,3,1,5,9,6,8,4,ryan
2025-04-04,PHO,@,BOS,"L, 103-123",24:45,8,1,5,0,0,0,1,1,0,5,6,5,6,1,ryan
2025-04-06,PHO,@,NYK,"L, 98-112",33:52,7,0,4,0,0,6,2,8,2,4,14,6,12,10,ryan
2025-04-08,PHO,,GSW,"L, 95-133",24:38,10,2,7,2,2,3,1,4,0,12,16,12,16,4,ryan
2025-04-09,PHO,,OKC,"L, 112-125",27:16,11,3,8,0,0,2,5,7,0,13,20,13,20,7,ryan
2025-04-11,PHO,,SAS,"W, 117-98",33:58,21,4,11,2,2,5,6,11,1,26,38,27,37,12,ryan
2025-04-13,PHO,@,SAC,"L, 98-109",29:47,11,2,6,0,0,6,4,10,3,12,25,15,22,13,ryan
