Date,Team,Where,Opp,Result,MP,FGA,3P,3PA,FT,FTA,ORB,DRB,TRB,AST,PTS,PAR,PA,PR,AR,name
2024-10-23,CLE,@,TOR,"W, 136-106",27:40,14,2,5,5,7,0,2,2,3,21,26,24,23,5,donovan
2024-10-25,CLE,,DET,"W, 113-101",30:07,21,1,8,2,4,1,1,2,5,19,26,24,21,7,donovan
2024-10-26,CLE,@,WAS,"W, 135-116",29:18,18,6,11,2,3,1,3,4,5,30,39,35,34,9,donovan
2024-10-28,CLE,@,NYK,"W, 110-104",33:15,17,3,8,4,4,0,2,2,5,25,32,30,27,7,donovan
2024-10-30,CLE,,LAL,"W, 134-110",30:27,20,4,10,0,0,1,2,3,7,24,34,31,27,10,donovan
2024-11-01,CLE,,ORL,"W, 120-109",22:04,15,2,5,2,2,0,3,3,1,22,26,23,25,4,donovan
2024-11-02,CLE,@,MIL,"W, 114-113",34:33,25,4,8,4,4,2,1,3,4,30,37,34,33,7,donovan
2024-11-04,CLE,,MIL,"W, 116-114",31:05,15,3,7,1,2,0,4,4,4,14,22,18,18,8,donovan
2024-11-06,CLE,@,NOP,"W, 131-122",33:43,20,3,9,6,6,0,4,4,3,29,36,32,33,7,donovan
2024-11-08,CLE,,GSW,"W, 136-117",26:26,13,2,7,2,2,0,5,5,4,12,21,16,17,9,donovan
2024-11-09,CLE,,BRK,"W, 105-100",34:32,12,4,6,8,8,0,1,1,1,22,24,23,23,2,donovan
2024-11-11,CLE,@,CHI,"W, 119-113",34:33,26,7,16,5,6,1,7,8,2,36,46,38,44,10,donovan
2024-11-13,CLE,@,PHI,"W, 114-106",34:23,21,5,13,0,0,2,11,13,9,23,45,32,36,22,donovan
2024-11-15,CLE,,CHI,"W, 144-126",34:06,23,7,13,6,7,0,7,7,4,37,48,41,44,11,donovan
2024-11-19,CLE,@,BOS,"L, 117-120",40:09,29,3,11,6,8,1,7,8,3,35,46,38,43,11,donovan
2024-11-20,CLE,,NOP,"W, 128-100",19:37,10,1,5,1,2,0,2,2,2,10,14,12,12,4,donovan
2024-11-24,CLE,,TOR,"W, 122-108",34:39,18,5,9,1,1,0,4,4,1,26,31,27,30,5,donovan
2024-11-27,CLE,,ATL,"L, 124-135",36:25,24,4,14,6,8,0,4,4,7,30,41,37,34,11,donovan
2024-11-29,CLE,@,ATL,"L, 101-117",35:03,23,2,10,0,0,2,9,11,6,12,29,18,23,17,donovan
2024-12-01,CLE,,BOS,"W, 115-111",35:22,21,6,11,5,8,1,6,7,3,35,45,38,42,10,donovan
2024-12-03,CLE,,WAS,"W, 118-87",27:59,15,4,8,3,3,0,5,5,7,19,31,26,24,12,donovan
2024-12-05,CLE,,DEN,"W, 126-114",32:56,24,6,10,0,0,1,2,3,6,28,37,34,31,9,donovan
2024-12-07,CLE,@,CHO,"W, 116-102",36:08,12,5,10,1,2,1,7,8,8,18,34,26,26,16,donovan
2024-12-08,CLE,@,MIA,"L, 113-122",30:50,16,1,5,1,1,0,1,1,5,12,18,17,13,6,donovan
2024-12-13,CLE,,WAS,"W, 115-105",34:19,18,4,11,2,3,0,6,6,6,20,32,26,26,12,donovan
2024-12-16,CLE,@,BRK,"W, 130-101",30:22,14,3,10,3,4,0,3,3,5,18,26,23,21,8,donovan
2024-12-20,CLE,,MIL,"W, 124-101",27:13,15,3,7,6,8,0,4,4,6,27,37,33,31,10,donovan
2024-12-21,CLE,,PHI,"W, 126-99",27:54,16,4,10,1,1,0,4,4,5,19,28,24,23,9,donovan
2024-12-23,CLE,,UTA,"W, 124-113",33:42,15,4,8,4,5,0,3,3,7,22,32,29,25,10,donovan
2024-12-27,CLE,@,DEN,"W, 149-135",30:21,17,6,12,7,7,2,3,5,6,33,44,39,38,11,donovan
2024-12-30,CLE,@,GSW,"W, 113-95",27:21,19,5,11,0,0,0,3,3,4,23,30,27,26,7,donovan
2024-12-31,CLE,@,LAL,"W, 122-110",32:11,20,6,13,4,5,1,3,4,4,26,34,30,30,8,donovan
2025-01-03,CLE,@,DAL,"W, 134-122",26:44,11,2,7,3,3,0,0,0,6,15,21,21,15,6,donovan
2025-01-05,CLE,,CHO,"W, 115-105",29:16,16,3,7,0,0,0,3,3,4,19,26,23,22,7,donovan
2025-01-08,CLE,,OKC,"W, 129-122",35:09,16,2,7,3,4,1,5,6,4,11,21,15,17,10,donovan
2025-01-12,CLE,,IND,"L, 93-108",30:50,17,3,7,2,2,2,1,3,1,19,23,20,22,4,donovan
2025-01-14,CLE,@,IND,"W, 127-117",31:19,23,3,9,8,8,2,7,9,3,35,47,38,44,12,donovan
2025-01-16,CLE,@,OKC,"L, 114-134",20:41,15,1,4,1,2,0,2,2,2,8,12,10,10,4,donovan
2025-01-18,CLE,@,MIN,"W, 124-117",33:36,27,4,15,8,9,2,6,8,7,36,51,43,44,15,donovan
2025-01-20,CLE,,PHO,"W, 118-92",29:33,25,4,9,7,7,3,2,5,5,33,43,38,38,10,donovan
2025-01-22,CLE,@,HOU,"L, 108-109",35:03,21,1,8,4,5,2,1,3,3,19,25,22,22,6,donovan
2025-01-24,CLE,@,PHI,"L, 129-132",33:24,23,7,15,6,8,1,2,3,7,37,47,44,40,10,donovan
2025-01-25,CLE,,HOU,"L, 131-135",37:07,27,4,11,7,9,1,3,4,7,33,44,40,37,11,donovan
2025-01-27,CLE,,DET,"W, 110-91",30:54,12,2,6,7,7,0,2,2,6,21,29,27,23,8,donovan
2025-01-29,CLE,@,MIA,"W, 126-106",30:23,23,5,11,1,1,0,1,1,6,34,41,40,35,7,donovan
2025-01-30,CLE,,ATL,"W, 137-115",27:21,16,4,10,4,5,0,1,1,6,24,31,30,25,7,donovan
2025-02-02,CLE,,DAL,"W, 144-101",23:40,9,2,5,2,2,0,6,6,6,12,24,18,18,12,donovan
2025-02-04,CLE,,BOS,"L, 105-112",36:09,25,4,14,3,3,1,9,10,6,31,47,37,41,16,donovan
2025-02-07,CLE,@,WAS,"W, 134-124",34:08,26,4,11,5,5,0,1,1,5,33,39,38,34,6,donovan
2025-02-10,CLE,,MIN,"W, 128-107",32:21,14,2,5,1,3,0,3,3,8,23,34,31,26,11,donovan
2025-02-12,CLE,@,TOR,"W, 131-108",29:16,16,2,9,7,8,3,3,6,5,21,32,26,27,11,donovan
2025-02-20,CLE,@,BRK,"W, 110-97",30:16,21,3,9,7,10,3,2,5,2,26,33,28,31,7,donovan
2025-02-21,CLE,,NYK,"W, 142-105",26:08,15,5,7,2,3,0,3,3,5,27,35,32,30,8,donovan
2025-02-23,CLE,,MEM,"W, 129-123",35:09,23,4,8,7,11,2,0,2,6,33,41,39,35,8,donovan
2025-02-25,CLE,@,ORL,"W, 122-82",23:14,12,1,4,0,0,1,2,3,5,11,19,16,14,8,donovan
2025-02-28,CLE,@,BOS,"W, 123-116",35:08,26,5,12,10,11,0,3,3,5,41,49,46,44,8,donovan
2025-03-04,CLE,@,CHI,"W, 139-117",27:46,17,1,6,13,14,1,6,7,5,28,40,33,35,12,donovan
2025-03-05,CLE,,MIA,"W, 112-107",35:40,17,4,11,6,7,1,6,7,5,26,38,31,33,12,donovan
2025-03-07,CLE,@,CHO,"W, 118-117",35:57,19,0,6,12,18,0,3,3,1,24,28,25,27,4,donovan
2025-03-09,CLE,@,MIL,"W, 112-100",29:53,15,1,7,6,7,1,4,5,6,15,26,21,20,11,donovan
2025-03-16,CLE,,ORL,"L, 103-108",34:13,28,3,14,2,2,3,3,6,5,23,34,28,29,11,donovan
2025-03-18,CLE,@,LAC,"L, 119-132",33:33,18,2,9,6,6,1,3,4,11,18,33,29,22,15,donovan
2025-03-19,CLE,@,SAC,"L, 119-123",33:18,17,1,6,9,9,0,5,5,4,26,35,30,31,9,donovan
2025-03-21,CLE,@,PHO,"L, 112-123",30:43,18,0,8,3,4,0,4,4,3,7,14,10,11,7,donovan
2025-03-23,CLE,@,UTA,"W, 120-91",21:07,13,0,5,6,9,0,3,3,4,16,23,20,19,7,donovan
2025-03-27,CLE,,SAS,"W, 124-116",35:15,18,4,9,5,5,3,5,8,14,25,47,39,33,22,donovan
2025-03-28,CLE,@,DET,"L, 122-133",35:40,24,3,8,11,13,2,3,5,3,38,46,41,43,8,donovan
2025-03-30,CLE,,LAC,"W, 127-122",36:36,19,2,9,4,4,1,11,12,7,24,43,31,36,19,donovan
2025-04-02,CLE,,NYK,"W, 124-105",30:11,18,3,7,4,4,1,5,6,5,27,38,32,33,11,donovan
2025-04-04,CLE,@,SAS,"W, 114-113",33:36,18,6,11,4,6,1,2,3,7,26,36,33,29,10,donovan
2025-04-06,CLE,,SAC,"L, 113-120",33:00,16,1,6,4,7,1,5,6,6,19,31,25,25,12,donovan
