Date,Team,Where,Opp,Result,MP,FGA,3P,3PA,FT,FTA,ORB,DRB,TRB,AST,PTS,PAR,PA,PR,AR,name
2024-10-23,GSW,@,POR,"W, 140-104",14:44,12,5,7,1,1,1,4,5,1,22,28,23,27,6,buddy
2024-10-25,GSW,@,UTA,"W, 127-86",19:55,14,7,9,0,0,0,4,4,6,27,37,33,31,10,buddy
2024-10-27,GSW,,LAC,"L, 104-112",27:53,14,1,9,1,1,1,5,6,2,8,16,10,14,8,buddy
2024-10-29,GSW,,NOP,"W, 124-106",28:48,18,7,11,3,3,0,1,1,1,28,30,29,29,2,buddy
2024-10-30,GSW,,NOP,"W, 104-89",29:00,19,4,12,1,1,2,0,2,3,21,26,24,23,5,buddy
2024-11-02,GSW,@,HOU,"W, 127-121 (OT)",32:02,14,6,10,3,4,1,6,7,2,27,36,29,34,9,buddy
2024-11-04,GSW,@,WAS,"W, 125-112",27:39,14,3,8,3,4,0,5,5,2,20,27,22,25,7,buddy
2024-11-06,GSW,@,BOS,"W, 118-112",28:32,11,4,7,0,0,1,5,6,1,16,23,17,22,7,buddy
2024-11-08,GSW,@,CLE,"L, 117-136",19:21,4,1,4,0,0,0,2,2,1,3,6,4,5,3,buddy
2024-11-10,GSW,@,OKC,"W, 127-116",21:10,8,2,5,0,0,1,4,5,2,8,15,10,13,7,buddy
2024-11-12,GSW,,DAL,"W, 120-117",20:39,13,2,8,0,0,0,1,1,0,14,15,14,15,1,buddy
2024-11-15,GSW,,MEM,"W, 123-118",30:19,15,4,8,0,0,4,0,4,2,18,24,20,22,6,buddy
2024-11-18,GSW,@,LAC,"L, 99-102",23:22,7,2,6,0,0,0,2,2,1,8,11,9,10,3,buddy
2024-11-20,GSW,,ATL,"W, 120-97",20:00,11,3,9,0,0,0,2,2,0,11,13,11,13,2,buddy
2024-11-22,GSW,@,NOP,"W, 112-108",19:18,10,2,7,4,4,1,5,6,0,12,18,12,18,6,buddy
2024-11-23,GSW,@,SAS,"L, 94-104",23:51,9,3,7,0,0,1,0,1,4,11,16,15,12,5,buddy
2024-11-25,GSW,,BRK,"L, 120-128",16:44,12,2,8,1,1,1,2,3,1,9,13,10,12,4,buddy
2024-11-27,GSW,,OKC,"L, 101-105",23:01,8,5,8,2,2,0,3,3,0,17,20,17,20,3,buddy
2024-11-30,GSW,@,PHO,"L, 105-113",16:25,7,2,4,3,3,0,1,1,1,11,13,12,12,2,buddy
2024-12-03,GSW,@,DEN,"L, 115-119",21:24,8,2,6,0,0,0,3,3,0,6,9,6,9,3,buddy
2024-12-05,GSW,,HOU,"W, 99-93",27:10,8,1,6,2,2,0,5,5,2,5,12,7,10,7,buddy
2024-12-06,GSW,,MIN,"L, 90-107",13:22,4,0,2,0,0,0,3,3,0,4,7,4,7,3,buddy
2024-12-08,GSW,,MIN,"W, 114-106",34:34,18,7,13,0,0,1,3,4,2,27,33,29,31,6,buddy
2024-12-11,GSW,@,HOU,"L, 90-91",35:02,12,3,9,0,0,0,4,4,0,15,19,15,19,4,buddy
2024-12-15,GSW,,DAL,"L, 133-143",26:42,11,3,8,0,0,0,0,0,1,9,10,10,9,1,buddy
2024-12-19,GSW,@,MEM,"L, 93-144",19:42,6,1,3,0,0,0,4,4,0,9,13,9,13,4,buddy
2024-12-21,GSW,@,MIN,"W, 113-103",20:38,9,3,8,0,0,1,2,3,2,11,16,13,14,5,buddy
2024-12-23,GSW,,IND,"L, 105-111",16:01,11,3,6,0,0,1,3,4,1,13,18,14,17,5,buddy
2024-12-25,GSW,,LAL,"L, 113-115",17:27,6,1,5,0,0,0,0,0,0,5,5,5,5,0,buddy
2024-12-27,GSW,@,LAC,"L, 92-102",21:39,8,1,6,0,0,2,7,9,0,5,14,5,14,9,buddy
2024-12-28,GSW,,PHO,"W, 109-105",14:47,7,0,7,0,0,0,0,0,1,0,1,1,0,1,buddy
2024-12-30,GSW,,CLE,"L, 95-113",18:47,8,0,3,0,0,1,2,3,0,2,5,2,5,3,buddy
2025-01-02,GSW,,PHI,"W, 139-105",20:41,5,1,5,0,0,0,1,1,1,3,5,4,4,2,buddy
2025-01-04,GSW,,MEM,"W, 121-113",23:34,9,4,7,0,0,1,1,2,3,14,19,17,16,5,buddy
2025-01-05,GSW,,SAC,"L, 99-129",18:26,7,1,5,0,0,0,3,3,3,7,13,10,10,6,buddy
2025-01-07,GSW,,MIA,"L, 98-114",23:57,12,2,9,1,2,1,7,8,5,11,24,16,19,13,buddy
2025-01-09,GSW,@,DET,"W, 107-104",31:21,15,5,11,0,0,1,4,5,3,19,27,22,24,8,buddy
2025-01-10,GSW,@,IND,"L, 96-108",34:38,19,3,12,2,2,0,4,4,5,17,26,22,21,9,buddy
2025-01-13,GSW,@,TOR,"L, 101-104",33:03,13,2,10,0,0,0,2,2,3,8,13,11,10,5,buddy
2025-01-15,GSW,@,MIN,"W, 116-115",29:23,11,3,6,3,3,0,1,1,0,18,19,18,19,1,buddy
2025-01-18,GSW,,WAS,"W, 122-114",21:02,7,1,4,1,2,1,1,2,2,6,10,8,8,4,buddy
2025-01-20,GSW,,BOS,"L, 85-125",22:11,5,1,4,1,3,1,1,2,2,6,10,8,8,4,buddy
2025-01-22,GSW,@,SAC,"L, 117-123",25:20,12,5,9,0,0,1,2,3,1,17,21,18,20,4,buddy
2025-01-23,GSW,,CHI,"W, 131-106",19:15,7,0,5,1,1,0,2,2,2,3,7,5,5,4,buddy
2025-01-25,GSW,,LAL,"L, 108-118",21:15,9,2,8,2,3,1,3,4,0,10,14,10,14,4,buddy
2025-01-28,GSW,,UTA,"W, 114-103",22:01,7,0,4,0,0,0,3,3,4,2,9,6,5,7,buddy
2025-01-29,GSW,,OKC,"W, 116-109",15:15,6,1,4,0,0,0,5,5,4,5,14,9,10,9,buddy
2025-01-31,GSW,,PHO,"L, 105-130",19:07,7,3,5,0,0,0,3,3,2,13,18,15,16,5,buddy
2025-02-03,GSW,,ORL,"W, 104-99",18:52,4,0,2,2,3,0,1,1,0,4,5,4,5,1,buddy
2025-02-05,GSW,@,UTA,"L, 128-131",31:22,14,4,8,0,0,0,3,3,2,18,23,20,21,5,buddy
2025-02-06,GSW,@,LAL,"L, 112-120",35:03,13,4,9,0,0,2,3,5,5,14,24,19,19,10,buddy
2025-02-08,GSW,@,CHI,"W, 132-111",27:32,13,4,9,0,0,1,4,5,3,14,22,17,19,8,buddy
2025-02-10,GSW,@,MIL,"W, 125-111",30:11,15,2,8,0,0,1,6,7,1,16,24,17,23,8,buddy
2025-02-12,GSW,@,DAL,"L, 107-111",28:52,9,1,6,0,0,0,3,3,0,3,6,3,6,3,buddy
2025-02-13,GSW,@,HOU,"W, 105-98",13:56,5,0,4,0,0,0,1,1,0,2,3,2,3,1,buddy
2025-02-21,GSW,@,SAC,"W, 132-108",25:45,11,5,8,1,1,0,3,3,2,22,27,24,25,5,buddy
2025-02-23,GSW,,DAL,"W, 126-102",17:50,4,1,3,0,0,0,2,2,2,3,7,5,5,4,buddy
2025-02-25,GSW,,CHO,"W, 128-92",19:32,11,4,9,0,1,1,1,2,1,16,19,17,18,3,buddy
2025-02-27,GSW,@,ORL,"W, 121-115",17:36,5,1,3,0,0,1,0,1,2,3,6,5,4,3,buddy
2025-03-01,GSW,@,PHI,"L, 119-126",16:34,9,0,6,0,0,2,0,2,3,6,11,9,8,5,buddy
2025-03-03,GSW,@,CHO,"W, 119-101",31:14,14,5,9,1,1,0,5,5,2,22,29,24,27,7,buddy
2025-03-04,GSW,@,NYK,"W, 114-102",23:02,13,3,10,0,0,1,5,6,0,15,21,15,21,6,buddy
2025-03-06,GSW,@,BRK,"W, 121-119",22:52,8,0,5,0,0,0,1,1,1,0,2,1,1,2,buddy
2025-03-08,GSW,,DET,"W, 115-110",19:01,7,1,5,1,2,1,3,4,2,8,14,10,12,6,buddy
2025-03-10,GSW,,POR,"W, 130-120",25:00,10,6,9,0,0,2,0,2,7,20,29,27,22,9,buddy
2025-03-13,GSW,,SAC,"W, 130-104",19:35,10,4,6,0,1,0,4,4,5,16,25,21,20,9,buddy
2025-03-15,GSW,,NYK,"W, 97-94",14:34,7,1,7,0,0,0,2,2,0,3,5,3,5,2,buddy
2025-03-17,GSW,,DEN,"L, 105-114",20:59,4,0,3,0,0,0,0,0,1,2,3,3,2,1,buddy
2025-03-18,GSW,,MIL,"W, 104-93",23:31,7,4,6,1,1,0,6,6,0,15,21,15,21,6,buddy
2025-03-20,GSW,,TOR,"W, 117-114",19:24,4,1,3,5,5,2,3,5,4,8,17,12,13,9,buddy
2025-03-22,GSW,@,ATL,"L, 115-124",16:43,2,1,1,2,2,1,1,2,1,5,8,6,7,3,buddy
2025-03-25,GSW,@,MIA,"L, 86-112",25:32,8,2,5,2,2,0,3,3,0,10,13,10,13,3,buddy
2025-03-28,GSW,@,NOP,"W, 111-95",22:52,8,2,6,1,1,1,2,3,3,11,17,14,14,6,buddy
2025-03-30,GSW,@,SAS,"W, 148-106",24:34,12,3,6,0,0,1,4,5,4,19,28,23,24,9,buddy
2025-04-01,GSW,@,MEM,"W, 134-125",20:08,7,2,7,2,2,1,2,3,0,8,11,8,11,3,buddy
2025-04-03,GSW,@,LAL,"W, 123-116",12:36,3,0,3,0,0,1,2,3,0,0,3,0,3,3,buddy
2025-04-04,GSW,,DEN,"W, 118-104",16:44,6,1,3,0,0,2,0,2,0,5,7,5,7,2,buddy
2025-04-06,GSW,,HOU,"L, 96-106",25:06,14,6,11,0,0,0,2,2,2,20,24,22,22,4,buddy
2025-04-08,GSW,@,PHO,"W, 133-95",21:10,8,1,6,0,0,1,3,4,1,7,12,8,11,5,buddy
2025-04-09,GSW,,SAS,"L, 111-114",26:29,13,4,10,0,0,1,3,4,1,12,17,13,16,5,buddy
2025-04-11,GSW,@,POR,"W, 103-86",22:38,14,4,10,0,0,1,3,4,0,16,20,16,20,4,buddy
2025-04-13,GSW,,LAC,"L, 119-124 (OT)",15:45,7,2,6,0,0,0,1,1,0,8,9,8,9,1,buddy
